12 14
W W W W W W W W W W W W W W 
W _ _ _ _ _ _ _ _ _ _ _ _ W
W _ _ _ _ _ _ _ _ _ _ _ _ W
W _ _ _ B _ _ _ _ _ P _ _ W
W _ _ _ _ _ _ _ _ _ P _ _ W
W _ _ _ _ _ _ _ _ _ _ _ _ W
W _ _ _ _ _ _ _ _ _ _ _ _ W
W _ _ _ _ _ _ _ _ _ B _ _ W
W _ _ _ _ _ _ _ _ _ _ _ _ W
W _ _ _ _ _ _ _ _ _ _ _ _ W
W _ _ T _ _ _ _ _ _ _ _ T W
W W W W W W W W W W W W W W	
1