8 8
W W W W W W W W
W _ _ _ W _ _ W
W _ W _ W B T W
W _ _ _ _ B T W
W _ W _ W B T W
W _ _ _ W _ _ W
W W W W W P _ W
W W W W W W W W
100